+--+--+--+--+--+--+--+--+--+--+
|p                            |
+  +--+--+--+--+--+--+--+--+  +
|  |        |              |  |
+  +  +--+--+--+--+  +--+--+  +
|  |        |     |  |        |
+  +--+--+  +  +  +  +  +--+--+
|        |     |  |     |     |
+--+  +  +--+--+  +  +--+  +  +
|  |  |     |     |     |  |  |
+  +  +--+--+  +--+--+  +  +  +
|  |        |     |  |  |  |  |
+  +--+--+  +--+  +  +  +--+  +
|        |  |     |     |     |
+--+--+  +  +  +--+  +--+  +  +
|        |     |  |        |  |
+  +--+--+--+--+  +--+--+--+  +
|                 |     |     |
+  +--+--+  +--+--+  +  +  +--+
|        |           |       g|
+--+--+--+--+--+--+--+--+--+--+