+--+--+--+--+--+--+
|p             |  |
+  +--+--+  +  +  +
|     |     |     |
+--+--+  +--+--+--+
|        |        |
+  +--+--+  +--+  +
|  |        |     |
+  +  +--+--+--+--+
|  |        |     |
+  +--+--+  +  +  +
|              | g|
+--+--+--+--+--+--+